40, 90, 90
########################
|----|---|----|--------|
|####|###|####|########|
|--##|##-|###-------###|
|####|#################|
|##1---######---|---|##|
|###############|###|##|
|---|----|-|####|######|
|###|######|-----######|
|###|###|##|###########|
|###|###|###-#######|##|
|###|###|###########|--|
|##-|-------###|--##|##|
|###|##########|####|##|
|###|----------|#######|
|###############---####|
|######2###############|
#----------------------#